0000000000000000000
0111001110111111110
01E100101010C000010
01P1111011111111010
0100C00000000000010
0111111011101111110
0000001C10101000000
0000001010101111110
00000010101000C0010
0000001110111111110
0000000000000000000
0000000000000000000