00000000000000000000
00000000000000000000
01111111111111000000
110E0001000001110000
100P0000000000C10000
11000001000001110000
01111111111111000000
00000000000000000000
00000000000000000000