111000000000000000000000000000000000
101000001111110000000000000000000000
111000001000011111111111111111111000
0000000110000000000000000T0000001000
0000000100000000C0000000000000001000
000000010000000000000000001111111000
00000001000100000000T000000100000000
000000010001000000000E00000100000000
000000011111111111111111111100000000
000000000001000000000000000000000000
000000000001000000000000000000000000
000000000001000000000000000000000000
000000000000000000000000000000000000
