



000000000000000000000
001111111000000000000
001TTCTT1011111100000



001TTTTT101TTET100000
0111TT1111111T1110000
01TTTTT1D1DD1T1D10000



01TTTTTTTTTTTTTT10000
011T11111111111111000

01TT1DTT1TTTT10000000
01TTTTTTTTTTT10000000




01TT1TTT1TTTT10000000
011111111111110000000
000000000000000000000



