000000000000000000000
001111111000000000000
00100P001011111100000
001000001010000100000
011100111111101110000
010C0001DDDD101010000
010000000000C00010000
011011111101111110000
00101D001000010000000
00100000000C010000000
001010E01000010000000
001111111111110000000
000000000000000000000