000000000000000000000
001111111000000000000
00100E001011111100000
001000001010000100000
011100111111101110000
01000001D1DD101D10000
010000000000000010000
011011111111111111000
01001D001000010000000
01000P00000C010000000
01001000100P010000000
011111111111110000000
000000000000000000000