000000000000000000000
001111111000000000000
00100E001011111100000
0010000010100E0100000
011100111111101110000
01000E01D1DD101D10000
010000000000E00010000
011011111111111111000
01E01D001000010000000
010000P0000CP10000000
010010E0100C010000000
011111111111110000000
000000000000000000000