111111111111111111111
100000000000000000E01
101110101111000P00001
101010101001000000001
101011101111000000001
100000000000000000001
10111101111011100C001
10100101001010000C001
101111011100100100001
10100101001011110C001
100000000000000000001
111111111111111111111



