00000000000000000000000000000000000000000000000000000000000000000
00000000000000000000000000000000000000000000000011100000000000000
0000000000000000000000000000000000000000000000001E100000000000000
00000000000000000000000000000000000000000000000010100000000000000
00000000000000000000000000111111111111111111111110100000000000000
00000000000000000000000000100000000000000000000000100000000000000
00000000000000000000000000101111111111111111111111100000000000000
00000000000000000000000000101000000000000000000000000000000000000
00000000000000000000000000101000000000000000000000000000000000000
00000000000000000000000000101000000000000000000000000000000000000
000000000000000000000000001P1000000000000000000000000000000000000
00000000000000000000000000101000000000000000000000000000000000000
00000000000000000000000000101000000000000000000000000000000000000
00000000000000000000000000101000000000000000000000000000000000000
00000000000000000000000000101000000000000000000000000000000000000
00000000000000000000000000101000000000000000000000000000000000000
00000000000000000000000000101000000000000000000000000000000000000
00000000000000000000000000101111111111100000000000000000000000000
0000000000000000000000000010000000000010C000000000000000000000000
00000000000000000000000000111111111111100000000000000000000000000
00000000000000000000000000000000000000000000000000000000000000000
00000000000000000000000000000000000000000000000000000000000000000
00000000000000000000000000000000000000000000000000000000000000000
00000000000000000000000000000000000000000000000000000000000000000
00000000000000000000000000000000000000000000000000000000000000000
