0000000000000000000
0011111110000000000
00100P0010111111000
0010000010100E01000
0111001111111011100
010C000100001010100
010000000000C000100
0110111111011111100
0010100010000100000
00100000000C0100000
0010100010000100000
0011111111111100000
0000000000000000000