000000000000000000000
001111111000000000000
001D0P001011111100000
0010000010100E0100000
011100111111101110000
010C0001DDDD101010000
010000000000C00010000
011011111101111110000
001010D01000010000000
00100000000C010000000
001010001000010000000
001111111111110000000
000000000000000000000