1111111111111111111
1C0000E000000011111
1000000000000001001
1111111100000000001
1DDDD10000101000001
1000000000111000001
1000100000010001001
1001110000000011111
1000100000100000001
1000000000000T00001
1111111111111111111