1111111111111111111
1P00C0E000000011111
1000000000000001001
1111111100000000001
1DDDD10000101000001
1000000000111000001
1000100000010001001
10011100C0000011111
1000100000100000001
10000C0000000000C01
1111111111111111111