1111111111111111111
1C00000000000011111
10100T0000000000001
1111111100000000001
1111111111111111111